Date,Name,Withdraw,Deposit,Balance
1/12/2023,OPEN ACCOUNT        ,0,,0
1/24/2023,SSV FRM: 02876663314,,1,1
1/31/2023,SSV FRM: 02876663314,,1,2
2/3/2023,SSV FRM: 02876663314,,0.5,2.5
2/7/2023,SSV FRM: 02876663314,,0.5,3
2/14/2023,SSV FRM: 02876663314,,1.5,4.5
2/21/2023,SSV FRM: 02876663314,,1,5.5
2/22/2023,SSV FRM: 02876663314,,1.5,7
2/28/2023,SSV FRM: 02876663314,,1.5,8.5
3/1/2023,SSV FRM: 02876663314,,0.5,9
3/2/2023,SSV FRM: 02876663314,,0.5,9.5
3/6/2023,SSV FRM: 02876663314,,0.5,10
3/7/2023,SSV FRM: 02876663314,,1,11
3/8/2023,SSV FRM: 02876663314,,0.5,11.5
3/14/2023,SSV FRM: 02876663314,,1,12.5
3/16/2023,SSV FRM: 02876663314,,0.5,13
3/21/2023,SSV FRM: 02876663314,,0.5,13.5
3/27/2023,SSV FRM: 02876663314,,0.5,14
3/28/2023,SSV FRM: 02876663314,,0.5,14.5
4/4/2023,SSV FRM: 02876663314,,1.5,16
4/6/2023,SSV FRM: 02876663314,,0.5,16.5
4/11/2023,SSV FRM: 02876663314,,1,17.5
4/14/2023,SSV FRM: 02876663314,,0.5,18
4/17/2023,SSV FRM: 02876663314,,2,20
4/18/2023,SSV FRM: 02876663314,,1.5,21.5
4/18/2023,WU390 TFR-TO 6663314,10,,11.5
4/19/2023,SSV FRM: 02876663314,,1,12.5
4/20/2023,SSV FRM: 02876663314,,0.5,13
4/21/2023,SSV FRM: 02876663314,,0.5,13.5
4/24/2023,SSV FRM: 02876663314,,0.5,14
4/25/2023,SSV FRM: 02876663314,,2.5,16.5
4/25/2023,SEND E-TFR ***2vq   ,10,,6.5
4/25/2023,SEND E-TFR FEE      ,0.5,,6
4/28/2023,SSV FRM: 02876663314,,0.5,6.5
5/2/2023,SSV FRM: 02876663314,,1,7.5
5/3/2023,SSV FRM: 02876663314,,0.5,8
5/4/2023,SSV FRM: 02876663314,,0.5,8.5
5/5/2023,SSV FRM: 02876663314,,1.5,10
5/8/2023,SSV FRM: 02876663314,,0.5,10.5
5/9/2023,SSV FRM: 02876663314,,1.5,12
5/23/2023,WQ355 TFR-TO 6663314,12,,0
5/31/2023,SSV FRM: 02876663314,,1,1
6/2/2023,SSV FRM: 02876663314,,1.5,2.5
6/5/2023,SSV FRM: 02876663314,,1,3.5
6/8/2023,SSV FRM: 02876663314,,0.5,4
6/9/2023,SSV FRM: 02876663314,,0.5,4.5
7/5/2023,SSV FRM: 02876663314,,0.5,5
8/15/2023,SSV FRM: 02876663314,,2.5,7.5
9/19/2023,SSV FRM: 02876663314,,0.5,8
9/22/2023,SSV FRM: 02876663314,,0.5,8.5
9/25/2023,SSV FRM: 02876663314,,1,9.5
9/26/2023,SSV FRM: 02876663314,,0.5,10
9/29/2023,SSV FRM: 02876663314,,0.5,10.5
10/4/2023,SSV FRM: 02876663314,,0.5,11
10/6/2023,SSV FRM: 02876663314,,0.5,11.5
10/11/2023,SSV FRM: 02876663314,,2,13.5
10/12/2023,SSV FRM: 02876663314,,0.5,14
10/13/2023,SSV FRM: 02876663314,,0.5,14.5
10/16/2023,SSV FRM: 02876663314,,0.5,15
10/17/2023,SSV FRM: 02876663314,,1,16
10/24/2023,SSV FRM: 02876663314,,1,17
10/27/2023,SSV FRM: 02876663314,,0.5,17.5
11/2/2023,SSV FRM: 02876663314,,0.5,18
11/7/2023,SSV FRM: 02876663314,,1,19
11/28/2023,SSV FRM: 02876663314,,0.5,19.5
12/4/2023,SSV FRM: 02876663314,,0.5,20
12/6/2023,SSV FRM: 02876663314,,0.5,20.5
12/21/2023,SSV FRM: 02876663314,,0.5,21
12/28/2023,SSV FRM: 02876663314,,0.5,21.5
1/3/2024,SSV FRM: 02876663314,,0.5,22
1/8/2024,SSV FRM: 02876663314,,1,23
1/9/2024,SSV FRM: 02876663314,,1,24
1/25/2024,SSV FRM: 02876663314,,0.5,24.5
